1111111111111
1001000001C11
10C001C011001
1P0011E0000C1
1111111111111
