1111111111111
1001000000C11
10C001C011001
1P0011EC00011
1111111111111